0000000000000000000000000000000000000000000000000000000000000000000000000000000000000000000000000000
0555555000000000011111000000000555555500000000000005555550000000000000000000000000000000000000000000
0555555550000000011110000000000000005500000000055555555555500100000000555555555000000000000000000000
0555555555000000000111110000000000005500000055555555555000001115555555550000000000000000000000000000
0555555555500000000000000000000000005500000055555555500000000100000555555555000000000000000000000000
0555555555550000000000555555550000005500000055555500000000000000000555555550000000000000055555500000
0555555555550000000000000555555555555555555555555555555550000000000555555550000000000055555555000000
0555555555555000000000000005555555555555555555555555555555000000005555555555555555555555555500000000
0555555555555500000000000005555555555555555555555555555555000000555555555555555555555555500000000000
0555555555555500000000000000000555555555555555555555555555000000005555555555500000555550000000000444
0555555555555550000011111110000000055555555555555555555555500005555555000000000055555110000000444444
0555555555555550000000111111111100055555555555555555550000000011111550000000005555111110000004444444
0555111115555550000000011111111110055555555555555111100000000011111000000005555511111106660044444444
0555511115555555500001111111000000005555555555500011110000000000000000000555555111116666666666666669
0555111111111555555555555555555555555551555555555511111555555555555555055555000001111111666544444444
0555111155555555555555555555555555555551155555555555555555555555555555555555555551111111666554444444
0555111155555555555555555555555555555555555555555555555555555555555555555555555551111100666555444444
0555551111155555555555555555555555555555555555555555551111115555555555555555555501111111166555550444
0555111111555555555555551111155555555550005555555555511111155555555550000000000011111111666555500000
0555111111555555555555511111115555555550011555555555551111155555555500000000000000001111555550000000
0555111111155555555551111111111555555555555555555055555555555555555000000000000000000005555555000000
0551111555555555555555111111115555555555555555555555555555555551111100000000000000000005555555500000
0551111155555555555555511111115555555551155555155555555555555555111111555555555555555555555000000000
0551111155555555555555555511155555555555555555555555555555555555555555555555555555555555555555000000
0555555555555555555555555555555555555555555555555555555555555555555555555555555555555555555555500000
0555555555555555555555555555555555555555551155555555555555555555555555555555555555555555511115000000
0555555555555555555555555155555555555555555155555555555555511555555555555555555555555555555111110000
0555555555555555555555555555555555555555555555555550555555111110000000000000000000000000000000000000
0555555555111111115555555555555555555555555555555555555551111100000000000000000000000000000000000000
0000000000011111111100000000000000000000000000000000000001111100000000000000000000000000000000000000