0000000000000000000000000000000000000000000000000000
0555555555555555555555555595000000050000000055555550
0500000000000000000000000555000000050555550000005500
0505555555555500000005005555555555555500050555555500
0500000555555555550005005000005000000500000500000500
0500050000050000000005005005555555000500000500000550
0500550000555555555555005000000000055555555555555550
0500500000550000005000000055555555550000005000000500
0500555555550055555555555550000000550000555000555550
0500000000550000000000000000000000000000000000000000
0505550000555555555555555555555555555555555555555500
0500055555555555555555555555555555555555555555555500
0500050000000000000000000000000550000000000000005500
0550055555000000000000000000000050055555555555555500
0500000005055555555555555555555050055555555555555500
0505555505055555555555555555555055055000000000005000
0500000505050000000000500000055005055000055550005050
0500000505055555550000500000055005055005550050005050
0500000500000000550000555500055005055000000050005050
0505555555555550500055500550055005055555555550005050
0505000000000000500000000050055055055000000050005050
0505005555555555555555555050055050055000000000005050
0505005000000000000000050055055050055555555555505050
0505005000555555555000000050055050055555555555500050
0505005000500000000055555550055055000050000000500550
0505050000500000555550005000550005555055000000500500
0505550000500000000000000000055000000000000000500500
0555855555555555555555555555555555555555555000505550
0005550000000500000055000000000500000050000000500050
0005000000000500000055555500000500000050000000500050
0005000000000500000000000005555500000005555555505550
0005000055555505555555555555000000000000000000500050
0005000000055005005005000005000000000000000000500050
0005000000055005005005500005555555555555555555500050
0005555555055005555000555500005000000000000000000050
0005000500000005000000000500005000005055555000000050
0055000555555505555555550555505000005050000000000050
0050000000000005500000050000505555555055555555555550
0055555500055555500000050000000000000000000000000050
0000000500000000500000055555555555555555555555555050
0000000500000000555550050000500000000000055000005050
0005555555555550000050055500500000055550005550555050
0005005000000050000050005500555555550055000000005050
0005000005555550000000505500000500000000000000055050
0005550055000000055550500555550550000005555555550050
0000000550000000000050000000000055000000500000000050
0000005500000000000055555555555550000000500000000550
0000005000000000000000000000005000005555500055555500
0000555555555555555555555500005000000000500050000000
0055500000050000000000000500000000000000555555550000
0550500000055555555500000555555555555555500000055550
0000000000000000000000000000000000000000000000000000