0000000000000000000000000000000
0555555555557668667555555555550
0555500055557666667555500055550
0555500055557666667555500055550
0555500055557666667555500055550
0555555555557666667555555555550
0555555555557666667555555555550
0555555555557666667555555555550
0555500055557666667555500055550
0555500055557666667555500055550
0555500055557666667555500055550
0555555555557666667555555555550
0555555555557666667555555555550
0555555555557666667555555555550
0555500055557666667555500055550
0555500055557666667555500055550
0555500055557666667555500055550
0555555555557666667555555555550
0555555555557666667555555555550
0555555555557666667555555555550
0555500055557666667555500055550
0555500055557666667555500055550
0555500055557666667555500055550
0555555555557666667555555555550
0555555555557666667555555555550
0555555555557666667555555555550
0555500055557666667555500055550
0555500055557666667555500055550
0555500055557666667555500055550
0555555555557666667555555555550
0555555555550009000555555555550
0000000000000000000000000000000