0000000000000	
0000033300000
0576636366750
0576666666750
0576666666750
0576666666750
0576666666750
0576666666750
0576666666750
0557666667550
0055768675500
0000000000000